1111111111111111111111111111111111111111111111111111111111111111111111111111111111111
1S00110000000001000000010000000001000000000001001100100000000401000000000010300100001
1000110030000001000000410000000001000000000001000000100300000001000040000010000104001
1000110000000000030000010000040001003000000001040000100000000001000000000010300100001
1000111111111000000000010000000001000000000001000000111111111000001111111110000111001
1000000000011004000001111110000001111111000001000000000001000000000010000400001400001
1111111000011000000000000000000001000000000001111100000001000030000010000000010000001
1111111000011000000001111110000001000000000001000400000000000000000000000000000003001
1000000000011111110001000000000001004000000001000000111110000000004000000001000000001
1030000000000000010001000000000001000000000001030000100010400000000000000010000000001
1000000000000040011111000000000001111111111001111111100011111110000000000103000011111
1111111111100000000000000000000000000000001000000000000000000000000111111000000010001
1000000000000000010000000030111111111110001000000300000000000000000000000000000010401
1300000000000000011110000000100030000000001000000000000400000004000111111000000010001
1111111110000000000000000000111111111111111000000000000000000000001000000000001110401
1000000000000000011110000000000001000000000001111111100000000000010000000000000000001
1000004000000000010000000030000001000000000001000000100000000000100001100000001111111
1000000001111111110000000000000000000000000001000040100030000001000001100000000000401
1110000001000000000000000000000000000000000001000000000000000004000000000000000030001
1110000001004000000000000111111111000000000001000111100000000100000001111111000000001
1400000001111111110000000000000001000000000001000000000000001000000000000100000111111
1000000000000000110000300000000001000000000001000000100000010110000110300100000100001
100003000000000031000000000004000100000000000100030010000010010010001000010300000E001
1111111111111111110000000000000001000000000001300000100001000130030410300100040000001
1111111111111111111111111111111111111111111111111111111111111111111111111111111111111