1111111111111111111111111111111111111111111
1S00000000000000311000000011000000110000001
1030000000110000011000000011000000114000001
1000040000110000011000000011001100110000001
1000000000110000011400000011001100000000001
1000011000110000011000000000001100000000001
1030011000110040000000001100001100300000001
1000011000110000000000001100001100000000001
1000011000110000000000001100001100001100001
1000011000110000011000001100001100001130001
1030011000110000011000001100001100001100001
1000011000110000011000001100001100001100001
1000011000110000011000001100001100001100001
10000110041100000110000011000411000011000E1
1111111111111111111111111111111111111111111