1111111111111111111111111111111111111111111
1S00000000D00000311000000011000000110000001
1030000000110000011000000011000000114000001
1000040000110000011000000011AT1100110000001
1000000000110000011400000011001100000000001
1000011000110000011000000000001100000000001
10300110001100400C0000001100001100300000001
10000110001100000B0000001100001100000000001
10000110001100000A0000001100001100001100001
1000011000110000011000001100001100001130001
1030011000110000011000001100001100001100001
1000011000110000011000001100001100001100001
10000110TT110000011000001100001100001100001
1000011K041100000110000011000411000011000E1
1111111111111111111111111111111111111111111
