1111111111111111111111111111111111111111111
1S000000000000003110K0000011000000110000001
1030000000110000011000000011000000114000001
10000400001100000110TLL10311001100110000001
1000000000110000011400000011001100000000001
1000011000110000011000000D00001100000000001
1030011000110040000000001100001100300000001
1000011000110000RRRT00001100001100000000001
1000011000110000000000001100001100001100001
1000011000110000011000001100001100001130001
1030011000110000011000001100001100001100001
1000011000110000011000001100001100001100001
100001100011000001100000110RQ01100001100001
100001100411000001100000110Q0411000011000E1
1111111111111111111111111111111111111111111
