11111111
1S00A001
1030B001
1000C401
11110111
1L00Q001
10300001
11D11101
10000101
10000101
103001K1
11110111
10000L01
100000E1
11111111
