11111111
1S00A001
1030B001
1000C401
11110111
10000001
10300001
11011111
10000001
10000001
10300001
11110111
10000001
100000E1
11111111