11111111
1S000001
10300001
10000001
11110111
10000001
10300001
11011111
10000001
10000001
10300001
11110111
10000001
100000E1
11111111