11111111
1S000001
100RRR01
100000E1
11111111
