11111111
1S000001
10000001
100000E1
11111111
