11111111111111111111111111
1000L000000000000000000E01
10000111111111111111110001
1000000000L0K0000110000001
10030001100111110011000001
10001111110000011000D11111
100000110001100E0040000001
1000001100000000110400T001
10011111111111111111000001
10S00000111111100000001111
1000L00000000000000000E001
11111111111111111111111111

