11111111111111111111111111
10000000000000000000000001
10000000001111111000030001
10000000000000000110000001
10030001100E000E0011000001
10000011040000000001100001
10000011000E000E0040000001
10000011000000001104000001
10040001111111111000000001
10000000111111100000000001
10000000000000000000000001
11111111111111111111111111

