11111111111111111111111111
10000000000000000000000001
100000T0001111111000030001
10000000000000000110000001
10030001100E000E0011000001
1000001104000T000001100001
10000011000E000E0040000001
1000001100000000110400T001
10040001111111111000000001
10000000111111100000000001
10000000000000000000000001
11111111111111111111111111

