


                                 1
                                111
                              1100011
                            11000000011
                          110000000000011
                        1100000000000000011
                      11000000000000000000011
                    110000000000000000000000011
                      11000000000000000000011
                        1100000000000000011
                          110000000000011
                            11000000011
                              1100001
                                111
                                 1
