11111111111111111111111111
10000000000000000000000001
10000000001111111000030001
10000000000000000110000001
10030L01100E000E0011000001
10000011040000000001100001
10000011000E000E0040000001
10000011000000001104000001
1004000111111111100000L001
1000L000111111100000000001
10000000000000000000000001
11111111111111111111111111

