11111111111111111111111111
1S0000000200000000000000S1
10000000000000000000003001
10000000000000000000000001
100030000000E000E000000001
10000000000000000000000001
100000000000E000E000000001
10000000000000000004000001
10040000000000000000000001
10000000000000000000000001
1S0000000000000000000000S1
11111111111111111111111111

